##################A#######
#                       ##
#                      ###
#  #########   ###########
#  #########   ###########
#  #################0#####
#                       ##
#              ##       ##
#####################   ##
############# #######   ##
#     #   E #       #   ##
#     #     #       #   ##
#     #     #       #   ##
### ##### ###### ####   ##
#                       ##
#                       ##
##########################