##################A######
#                       #
#                       #
#  #########   ##########
#  #########   ##########
#  ######################
#                       #
#                       #
#####################   #
#####################   #
#     #   E #       #   #
#     #     #       #   #
#     #     #       #   #
### ##### ###### ####   #
#                       #
#                       #
#########################